000000111111000000
000111110011111000
111111000000111111
000111110011111000
000000111111000000
000000001100000000