000000000000000000
111111111111111111
000011111111110000
000011111111110000
111111111111111111
000000000000000000